NO ./textures/brick.xpm
SO ./textures/stone.xpm
WE ./textures/wood.xpm
EA ./textures/grey.xpm

F 200,150,90
C 205,240,255

11111111111111111
10000000000000001
10000000000000001
10000000000000001
10000000000000001
10000000000000001
10000000000000001
10000000000000001
10000000000000001
10000000000000N01
10000000000000001
11111111111111111
