NO ./textures/brick.xpm
SO ./textures/stone.xpm


WE ./textures/wood.xpm
EA ./textures/grey.xpm


F 200,150,90
C 205,240,255

       111111111
       100000001
1111111100000001
1000000000000001
1E00000000000001
1000000011111111
100000001
111111111
